{
	"tileset" : "World.png",
	"terrain" : 
	[

		[321, 322, 1, 1, 1, 1, 5, 1, 1, 5,  6,  2,  2,  2,  2,  2,  1, 2,  2,  2,  2,  5,  3],
		[6, 6, 6, 6, 6, 6, 6, 1, 1, 6,  2,  3,  2,  2,  3,  2,  6, 2,  2,  2,  2,  1,  1],
		[1, 1, 1, 1, 1, 1, 6, 1, 1, 6,  2,  2,  2,  2,  2,  2,  1, 2,  2,  2,  2,  1,  1],
		[1, 1, 1, 1, 1, 1, 6, 1, 1, 6,  6,  2,  2,  2,  2,  2,  1, 2,  2,  2,  2,  1,  1],
		[1, 1, 1, 1, 1, 1, 6, 1, 1, 6,  2,  2,  3,  2,  2,  2,  1, 2,  6,  6,  6,  6,  1],
		[1, 1, 1, 1, 1, 1, 6, 297, 298, 299,  2,  2,  305,  306,  2,  2,  1, 2,  6,  2,  2,  6,  1],
		[1, 1, 1, 1, 1, 1, 6, 313, 314, 315,  6,  6,  6,  6,  6,  6,  6, 6,  6,  2,  2,  6,  1],
		[1, 1, 1, 1, 1, 1, 6, 329, 330, 331,  1,  1,  1,  1,  1,  1,  1, 2,  2,  2,  2,  6,  1],
		[1, 1, 1, 1, 1, 1, 6, 1, 6, 5,  1,  1,  1,  1,  1,  1,  1, 2,  2,  2,  2,  6,  1],
		[1, 1, 1, 1, 1, 1, 6, 1, 6, 5,  2,  2,  2,  2,  2,  2,  1, 2,  2,  2,  2,  6,  1],
		[1, 1, 1, 1, 1, 1, 6, 1, 6, 5,  2,  2,  2,  2,  3,  2,  1, 2,  2,  2,  2,  6,  1],
		[1, 1, 1, 1, 1, 1, 6, 1, 6, 5,  2,  2,  2,  2,  2,  2,  6, 2,  2,  2,  2,  6,  1],
		[1, 1, 1, 1, 1, 1, 6, 1, 6, 5,  6,  2,  3,  2,  2,  2,  1, 2,  2,  2,  2,  6,  496],
		[1, 1, 1, 1, 1, 1, 6, 6, 6, 5,  2,  2,  2,  2,  2,  2,  1, 2,  2,  2,  2,  6,  496],
		[1, 1, 1, 1, 1, 1, 1, 1, 1, 5,  2,  2,  2,  2,  2,  2,  1, 2,  2,  2,  2,  6,  496],
		[334, 335, 1, 1, 1, 1, 1, 1, 1, 5,  2,  2,  2,  2,  3,  2,  1, 2,  2,  2,  2,  6,  496],
		[4, 4, 4, 4, 4, 4, 4, 1, 1, 5,  2,  2,  2,  2,  2,  2,  6, 2,  2,  2,  2,  2,  2],
		[565, 566, 565, 566, 565, 566, 4, 1, 1, 5,  6,  2,  3,  2,  2,  2,  1, 2,  2,  2,  3,  3,  3],
		[575, 576, 575, 576, 575, 576, 4, 1, 1, 5,  2,  6,  2,  2,  6,  2,  1, 2,  2,  2,  3,  3,  3]
	
	]
}



	


